149 699 218 705 131 879 61 864
230 706 297 712 213 868 143 851
317 712 415 718 340 913 233 898
417 718 527 722 461 928 340 915
527 723 650 723 598 941 463 930
651 725 780 728 746 950 599 942
781 728 916 728 909 956 748 951
916 728 1054 726 1070 953 910 959
1056 726 1195 725 1229 948 1071 954
1197 726 1327 722 1379 938 1230 950
1329 723 1447 715 1515 919 1379 936
1448 717 1558 711 1635 904 1515 921
1560 714 1660 708 1744 885 1637 904
1660 709 1748 697 1836 869 1744 884
1750 700 1833 685 1918 849 1837 869
484 407 567 406 504 529 411 527
568 407 653 404 601 525 504 530
653 404 745 401 708 525 602 527
745 400 841 398 815 524 709 527
841 398 938 395 929 524 815 524
938 395 1034 397 1044 524 930 525
1034 397 1134 395 1157 524 1045 524
1135 395 1229 397 1269 522 1158 525
1229 397 1322 400 1371 522 1270 522
1322 401 1410 403 1473 524 1371 522
1408 401 1492 403 1563 522 1473 525
1491 404 1569 407 1641 519 1561 524
1571 409 1644 409 1725 521 1643 521
542 316 616 313 567 396 483 396
618 316 694 309 651 391 568 396
696 311 775 305 743 390 653 393
777 306 858 305 840 387 743 388
860 305 942 305 938 385 841 387
944 305 1028 303 1034 385 938 385
1030 305 1116 303 1134 385 1033 385
1117 305 1197 305 1226 387 1134 387
1198 308 1279 308 1319 388 1227 387
1281 311 1358 313 1408 380 1321 378
1361 314 1431 313 1489 391 1408 390
1464 316 1505 320 1566 396 1521 393
1508 322 1572 320 1641 397 1568 397
515 176 572 171 533 241 477 242
573 171 633 165 596 237 535 242
634 165 693 161 663 233 598 237
693 161 752 158 731 228 663 233
752 158 821 155 803 227 732 230
823 155 886 152 875 221 804 228
886 153 950 153 950 221 875 222
952 153 1021 152 1022 221 950 221
1022 152 1086 153 1096 221 1024 222
1088 153 1152 155 1169 224 1097 224
1154 155 1218 158 1243 227 1171 225
1218 158 1281 161 1310 230 1244 228
1283 161 1342 164 1376 234 1310 231
1342 165 1404 168 1440 237 1378 236
1405 170 1462 173 1506 242 1440 239
